player_id,name,position,G,A,points,shots,timeOnIcePerGame
8478402,CONNOR MCDAVID,C,26,48,74,173,20.78
8477934,LEON DRAISAITL,C,29,43,72,160,21.35
8476453,NIKITA KUCHEROV,RW,24,41,65,158,18.11
8477492,NATHAN MACKINNON,C,25,39,64,233,20.22
8478550,ARTEMI PANARIN,LW,21,42,63,150,19.47
8477956,DAVID PASTRNAK,RW,30,32,62,201,18.1
8471215,EVGENI MALKIN,C,20,40,60,153,18.5
8476459,MIKA ZIBANEJAD,C,30,29,59,180,20.36
8478483,MITCHELL MARNER,C,16,43,59,149,20.23
8479318,AUSTON MATTHEWS,C,33,26,59,214,19.63
8474141,PATRICK KANE,bench,23,36,59,200,20.32
8473419,BRAD MARCHAND,LW,20,39,59,139,18.52
8478403,JACK EICHEL,C,24,33,57,188,20.72
8471675,SIDNEY CROSBY,C,19,37,56,139,19.31
8474564,STEVEN STAMKOS,C,24,32,56,155,17.57
8476456,JONATHAN HUBERDEAU,LW,18,37,55,127,17.9
8476460,MARK SCHEIFELE,C,22,31,53,130,20.63
8478420,MIKKO RANTANEN,RW,21,32,53,140,18.38
8477404,JAKE GUENTZEL,C,25,27,52,165,19.44
8478010,BRAYDEN POINT,C,21,30,51,123,17.99
8477493,ALEKSANDER BARKOV,C,17,33,50,137,19.25
8475913,MARK STONE,RW,19,31,50,135,18.48
8471214,ALEX OVECHKIN,LW,31,18,49,217,19.62
8478427,SEBASTIAN AHO,RW,24,25,49,160,18.55
8478398,KYLE CONNOR,LW,25,24,49,172,19.8
8476468,J.T. MILLER,C,18,31,49,121,18.55
8471218,BLAKE WHEELER,RW,14,34,48,133,18.53
8475791,TAYLOR HALL,LW,16,32,48,179,18.31
8475166,JOHN TAVARES,C,22,26,48,166,18.55
8470638,PATRICE BERGERON,C,23,25,48,163,17.81
8476346,JOHNNY GAUDREAU,LW,16,32,48,154,18.02
8474590,JOHN CARLSON,D,9,38,47,132,23.21
8476882,TEUVO TERAVAINEN,LW,13,34,47,135,18.15
8476454,RYAN NUGENT-HOPKINS,C,18,28,46,140,19.38
8479314,MATTHEW TKACHUK,LW,19,27,46,146,17.41
8475158,RYAN O'REILLY,C,13,33,46,110,19.6
8478445,MATHEW BARZAL,C,14,32,46,135,18.83
8476455,GABRIEL LANDESKOG,LW,20,25,45,149,19.2
8476461,SEAN COUTURIER,C,17,27,44,139,19.05
8479339,PATRIK LAINE,RW,22,22,44,176,18.25
8475810,BRYAN RUST,RW,21,23,44,137,18.4
8473604,JONATHAN TOEWS,C,15,28,43,133,18.92
8475744,EVGENY KUZNETSOV,C,15,28,43,116,17.09
8473563,NICKLAS BACKSTROM,C,11,32,43,111,18.23
8478444,BROCK BOESER,RW,17,25,42,158,17.77
8477496,ELIAS LINDHOLM,C,19,23,42,128,18.79
8476881,TOMAS HERTL,C,19,23,42,127,17.66
8477511,ANTHONY MANTHA,RW,19,23,42,164,17.9
8471685,ANZE KOPITAR,C,15,27,42,104,20.06
8474102,DAVID PERRON,LW,18,24,42,118,17.35
8477946,DYLAN LARKIN,C,16,26,42,176,20.18
8473512,CLAUDE GIROUX,C,14,28,42,142,18.27
8478439,TRAVIS KONECNY,C,17,24,41,120,15.97
8475794,TYLER SEGUIN,C,16,25,41,185,18.35
8477497,SEAN MONAHAN,C,18,23,41,131,17.37
8475170,BRAYDEN SCHENN,C,16,25,41,109,17.55
8474161,JAKUB VORACEK,RW,10,30,40,112,16.52
8477939,WILLIAM NYLANDER,C,18,22,40,151,17.12
8474884,MIKE HOFFMAN,LW,19,21,40,156,16.25
8476887,FILIP FORSBERG,LW,19,21,40,164,16.74
8474600,ROMAN JOSI,D,9,30,39,180,24.14
8475169,EVANDER KANE,LW,21,18,39,177,18.47
8474053,LOGAN COUTURE,C,16,23,39,129,17.68
8479337,ALEX DEBRINCAT,RW,18,21,39,153,16.77
8476448,WILLIAM KARLSSON,C,15,24,39,118,18.01
8477500,BO HORVAT,C,17,22,39,141,18.87
8474157,MAX PACIORETTY,LW,19,20,39,195,17.03
8477933,SAM REINHART,C,16,23,39,119,19.4
8475193,TOMAS TATAR,LW,15,24,39,125,15.68
8475191,REILLY SMITH,RW,17,22,39,125,17.13
8477940,NIKOLAJ EHLERS,LW,18,21,39,148,15.79
8478414,TIMO MEIER,RW,17,21,38,156,16.52
8475754,BROCK NELSON,C,18,20,38,131,17.89
8476458,RYAN STROME,C,14,24,38,112,18.23
8476792,TOREY KRUG,D,6,32,38,118,19.59
8475768,JADEN SCHWARTZ,LW,14,23,37,125,17.31
8475848,BRENDAN GALLAGHER,RW,20,17,37,191,16.17
8475168,MATT DUCHENE,C,14,23,37,113,16.39
8475184,CHRIS KREIDER,LW,19,18,37,131,16.54
8470613,BRENT BURNS,D,8,29,37,163,23.84
8471276,DAVID KREJCI,C,11,26,37,83,16.55
8475167,VICTOR HEDMAN,D,7,30,37,122,22.2
8479400,PIERRE-LUC DUBOIS,C,15,22,37,123,17.12
8475786,ZACH HYMAN,C,19,17,36,114,18.0
8477416,OLIVER BJORKSTRAND,RW,20,16,36,163,16.59
8473548,PHIL KESSEL,RW,13,23,36,120,16.52
8476462,DOUGIE HAMILTON,D,13,23,36,178,21.59
8474578,ERIK KARLSSON,D,4,32,36,125,23.07
8477503,MAX DOMI,LW,14,22,36,134,16.42
8476539,JONATHAN MARCHESSAULT,C,16,20,36,173,16.63
8475151,KYLE PALMIERI,RW,19,17,36,133,16.5
8477942,KEVIN FIALA,LW,15,21,36,134,14.88
8474149,EVGENII DADONOV,RW,17,19,36,124,16.52
8477479,TYLER BERTUZZI,LW,15,21,36,105,18.1
8476479,PHILLIP DANAULT,C,10,25,35,101,17.85
8477402,PAVEL BUCHNEVICH,RW,14,21,35,116,16.06
8475172,NAZEM KADRI,C,16,19,35,139,16.65
8478440,DYLAN STROME,C,12,23,35,98,15.37
8471724,KRIS LETANG,D,10,25,35,148,24.18
8476483,RICKARD RAKELL,C,14,21,35,148,17.38
8470595,ERIC STAAL,C,15,20,35,104,16.52
8471698,T.J. OSHIE,RW,17,18,35,107,17.49
8475763,KEVIN HAYES,C,16,19,35,128,17.01
8480002,NICO HISCHIER,C,13,22,35,122,17.26
8475176,RYAN ELLIS,D,7,27,34,112,22.2
8477444,ANDRE BURAKOVSKY,LW,15,19,34,95,14.18
8477944,JAKUB VRANA,LW,16,18,34,132,14.29
8476853,MORGAN RIELLY,D,6,28,34,137,22.67
8470610,ZACH PARISE,LW,17,17,34,126,16.62
8471228,ALEXANDER RADULOV,RW,14,20,34,120,16.4
8470612,RYAN GETZLAF,C,10,24,34,109,17.92
8475793,RYAN JOHANSEN,C,11,22,33,86,16.6
8473986,ALEX KILLORN,LW,16,17,33,104,16.79
8474715,CAM ATKINSON,RW,17,16,33,171,17.21
8476880,TOM WILSON,RW,16,17,33,119,17.4
8475722,JASON ZUCKER,LW,16,17,33,111,15.78
8474573,JOSH BAILEY,RW,10,23,33,81,16.2
8478519,ANTHONY CIRELLI,C,13,19,32,96,17.19
8479343,CLAYTON KELLER,C,12,20,32,136,15.86
8475314,ANDERS LEE,LW,16,16,32,144,17.35
8478042,VIKTOR ARVIDSSON,LW,18,14,32,131,15.88
8477951,NICK SCHMALTZ,C,9,23,32,81,15.21
8474679,GUSTAV NYQUIST,RW,12,20,32,120,17.18
8478469,THOMAS CHABOT,D,7,25,32,140,24.23
8474586,JORDAN EBERLE,C,14,18,32,121,16.9
8476389,VINCENT TROCHECK,C,10,22,32,126,16.35
8475197,TYSON BARRIE,D,6,26,32,128,20.68
8477447,SHEA THEODORE,D,9,22,31,152,20.86
8474565,ALEX PIETRANGELO,D,9,22,31,146,22.71
8477950,TONY DEANGELO,D,7,24,31,108,18.36
8471669,PAUL STASTNY,C,12,19,31,105,16.53
8477407,ANTHONY DUCLAIR,LW,17,14,31,137,15.28
8475692,MATS ZUCCARELLO,RW,11,20,31,88,15.74
8475798,MIKAEL GRANLUND,RW,13,18,31,116,17.08
8474037,JAMES VAN RIEMSDYK,LW,16,15,31,119,14.52
8476292,ONDREJ PALAT,LW,11,20,31,99,15.44
8474150,MIKAEL BACKLUND,C,12,19,31,125,17.13
8475906,JOHN KLINGBERG,D,6,25,31,110,21.25
8477494,JONATHAN DROUIN,LW,12,18,30,109,15.25
8476438,BRANDON SAAD,LW,17,13,30,126,16.17
8478099,KEVIN LABANC,RW,11,19,30,123,15.26
8470794,JOE PAVELSKI,C,15,15,30,106,16.49
8470966,MARK GIORDANO,D,6,24,30,131,22.54
8475726,TYLER TOFFOLI,C,15,15,30,149,16.19
8470606,DUSTIN BROWN,RW,14,16,30,129,17.77
8478498,JAKE DEBRUSK,LW,16,14,30,128,15.45
8471735,KEITH YANDLE,D,3,27,30,100,19.0
8477015,CONNOR BROWN,RW,11,19,30,118,18.47
8478460,ZACH WERENSKI,D,12,18,30,141,22.48
8476919,CHRIS TIERNEY,C,9,21,30,84,16.45
8470600,RYAN SUTER,D,4,26,30,85,23.38
8473994,JAMIE BENN,LW,14,16,30,122,15.97
8480113,ALEX IAFALLO,C,12,18,30,110,17.83
8476871,TANNER PEARSON,LW,15,15,30,120,15.61
8477495,SETH JONES,D,6,23,29,121,23.81
8479407,JESPER BRATT,LW,12,17,29,95,13.7
8478067,OSKAR LINDBLOM,LW,16,13,29,129,16.46
8475164,JAKOB SILFVERBERG,RW,15,14,29,123,16.86
8478131,ONDREJ KASE,RW,12,17,29,145,15.74
8474641,ADAM HENRIQUE,C,15,14,29,113,16.14
8471887,PATRIC HORNQVIST,RW,15,14,29,156,15.29
8476960,ANDREAS ATHANASIOU,LW,14,15,29,130,15.37
8475784,JEFF SKINNER,LW,16,12,28,157,16.04
8477949,ALEX TUCH,RW,13,15,28,124,14.42
8476288,RYAN DZINGEL,LW,11,17,28,90,14.01
8477955,JARED MCCANN,C,12,16,28,118,14.65
8476419,JEAN-GABRIEL PAGEAU,C,15,13,28,120,18.11
8478463,ANTHONY BEAUVILLIER,C,14,14,28,111,16.27
8476872,SCOTT LAUGHTON,C,13,15,28,87,14.15
8477932,AARON EKBLAD,D,6,22,28,116,21.75
8475820,JOONAS DONSKOI,RW,13,15,28,93,15.21
8477953,KASPERI KAPANEN,RW,12,16,28,105,15.29
8468508,JUSTIN WILLIAMS,RW,15,12,27,138,13.64
8476979,ERIK GUSTAFSSON,D,7,20,27,88,19.56
8475287,ERIK HAULA,LW,12,15,27,100,15.32
8480145,NEAL PIONK,D,4,23,27,121,21.82
8473507,JEFF PETRY,D,7,20,27,112,22.23
8475792,BRETT CONNOLLY,RW,14,13,27,94,13.93
8475799,NINO NIEDERREITER,RW,11,16,27,100,14.48
8476469,JOEL ARMIA,RW,14,13,27,137,16.36
8474189,LARS ELLER,C,11,16,27,113,16.26
8475745,CHARLIE COYLE,C,11,16,27,109,16.21
8466138,JOE THORNTON,C,8,19,27,65,14.96
8478401,PAVEL ZACHA,C,9,17,26,90,15.62
8470642,SHEA WEBER,D,10,16,26,141,22.55
8474563,DREW DOUGHTY,D,4,22,26,106,24.31
8477506,RYAN PULOCK,D,7,19,26,121,21.16
8477021,ALEXANDER KERFOOT,C,9,17,26,80,14.3
8475149,MARCUS JOHANSSON,LW,9,17,26,90,16.31
8477220,NATE SCHMIDT,D,6,20,26,101,20.66
8477456,J.T. COMPHER,LW,11,15,26,94,16.0
8476381,ANDREW SHAW,RW,10,16,26,100,14.16
8476826,YANNI GOURDE,C,10,16,26,85,13.83
8471303,ALEXANDER EDLER,D,5,21,26,105,21.55
8476472,OSCAR KLEFBOM,D,4,22,26,136,23.73
8478366,FRANK VATRANO,C,13,13,26,128,14.48
8477989,CHRISTIAN DVORAK,C,11,15,26,99,15.8
8475714,CALLE JARNKROK,C,11,15,26,103,15.29
8475178,ZACK KASSIAN,RW,12,14,26,90,15.01
8474870,TYLER JOHNSON,C,13,13,26,96,14.2
8471262,CARL SODERBERG,C,12,14,26,106,15.46
8476399,BLAKE COLEMAN,C,15,10,25,148,15.97
8479325,CHARLIE MCAVOY,D,5,20,25,87,21.69
8476410,JOSH LEIVO,LW,10,15,25,106,14.41
8474589,TYLER ENNIS,LW,12,13,25,114,13.76
8477504,JOSH MORRISSEY,D,5,20,25,96,21.46
8471707,JAMES NEAL,LW,14,11,25,112,15.54
8474716,JARED SPURGEON,D,8,17,25,94,21.47
8476480,VLADISLAV NAMESTNIKOV,C,12,13,25,85,14.55
8477499,RASMUS RISTOLAINEN,D,4,21,25,104,21.7
8474009,NICK BONINO,C,12,13,25,85,15.85
8478400,COLIN WHITE,C,8,16,24,85,15.19
8479410,MIKHAIL SERGACHEV,D,6,18,24,94,19.13
8477960,ADRIAN KEMPE,LW,9,15,24,109,15.26
8479316,LUKE KUNIN,C,11,13,24,108,14.96
8470604,JEFF CARTER,C,13,11,24,139,16.35
8478500,IVAN PROVOROV,D,8,16,24,108,23.4
8476856,MATT DUMBA,D,9,15,24,131,21.34
8478046,DANTON HEINEN,C,9,15,24,90,13.97
8476885,JACOB TROUBA,D,5,19,24,118,21.34
8475225,CRAIG SMITH,RW,13,11,24,132,13.25
8477941,NICK RITCHIE,LW,9,15,24,89,13.84
8474068,KYLE TURRIS,C,7,17,24,80,14.91
8473422,NICK FOLIGNO,LW,9,15,24,105,17.7
8475171,OLIVER EKMAN-LARSSON,D,7,17,24,108,21.77
8476958,JACCOB SLAVIN,D,5,19,24,107,22.03
8476924,MARTIN FRK,RW,14,10,24,81,12.99
8476851,ALEX GALCHENYUK,LW,9,15,24,88,12.41
8477429,ANDREW COPP,C,10,14,24,101,16.37
8477498,DARNELL NURSE,D,5,19,24,124,22.15
8477937,JAKE VIRTANEN,RW,12,12,24,114,12.95
8475218,MATTIAS EKHOLM,D,5,19,24,110,22.04
8475098,TYLER BOZAK,C,9,15,24,92,14.92
8475764,CAM FOWLER,D,6,17,23,96,20.93
8476923,DAMON SEVERSON,D,6,17,23,92,21.57
8479398,SAMUEL GIRARD,D,3,20,23,80,19.99
8475222,SAMI VATANEN,D,5,18,23,106,20.57
8478493,JOEL ERIKSSON EK,C,8,15,23,100,14.92
8476432,BOONE JENNER,C,10,13,23,132,17.2
8469459,MIKKO KOIVU,C,6,17,23,81,15.29
8478585,DEREK RYAN,C,8,15,23,80,14.02
8478458,JACK ROSLOVIC,C,9,14,23,89,13.89
8474613,DEREK STEPAN,C,8,15,23,124,17.04
8473533,JORDAN STAAL,C,8,15,23,107,16.83
8477476,ARTTURI LEHKONEN,LW,10,12,22,111,14.9
8477505,ALEXANDER WENNBERG,C,5,17,22,71,15.85
8476892,COLTON PARAYKO,D,8,14,22,127,21.71
8474162,JAKE MUZZIN,D,5,17,22,96,20.41
8470281,DUNCAN KEITH,D,2,20,22,93,22.81
8475855,JESPER FAST,RW,9,13,22,73,15.86
8476994,VINNIE HINOSTROZA,LW,7,15,22,104,13.01
8473544,DERICK BRASSARD,C,9,13,22,87,13.46
8475209,RICHARD PANIK,RW,9,12,21,70,11.77
8476897,OSKAR SUNDQVIST,C,10,11,21,92,13.87
8477839,CONOR SHEARY,LW,9,12,21,91,12.95
8479293,BRANDON TANEV,LW,9,12,21,83,14.22
8476393,NICK COUSINS,C,8,13,21,95,13.14
8479345,JAKOB CHYCHRUN,D,8,13,21,125,20.97
8474038,PAUL BYRON,LW,9,12,21,70,13.92
8475220,MARCUS FOLIGNO,LW,9,12,21,80,13.87
8475236,CODY EAKIN,C,9,12,21,76,14.2
8476906,SHAYNE GOSTISBEHERE,D,6,15,21,98,17.55
8478866,DOMINIK SIMON,C,7,14,21,92,13.86
8471274,ALEX GOLIGOSKI,D,3,18,21,77,21.53
8476854,HAMPUS LINDHOLM,D,4,17,21,99,21.85
8471233,TRAVIS ZAJAC,C,8,13,21,68,16.6
8474685,MATT CALVERT,LW,9,12,21,95,13.65
8476918,JIMMY VESEY,LW,9,11,20,87,13.65
8471702,MATT NISKANEN,D,5,15,20,92,20.73
8466139,PATRICK MARLEAU,C,9,11,20,95,15.1
8474031,KEVIN SHATTENKIRK,D,3,17,20,97,18.0
8473573,ARTEM ANISIMOV,C,12,8,20,93,13.71
8477425,MILES WOOD,LW,9,11,20,116,12.96
8475200,DMITRY ORLOV,D,3,17,20,80,21.07
8471676,BOBBY RYAN,RW,9,11,20,96,13.38
8477948,TRAVIS SANHEIM,D,6,14,20,86,19.04
8479370,TYSON JOST,C,8,12,20,94,12.48
8476889,RADEK FAKSA,C,10,10,20,88,15.29
8477964,IVAN BARBASHEV,C,9,11,20,63,12.89
8479465,DRAKE CAGGIULA,LW,11,9,20,81,11.9
8478569,NOEL ACCIARI,C,13,7,20,90,15.07
8474176,CARL HAGELIN,LW,6,14,20,94,13.85
8474683,DEREK GRANT,C,10,10,20,87,13.23
8476624,BARCLAY GOODROW,RW,7,13,20,81,14.76
8474190,WAYNE SIMMONDS,RW,8,12,20,97,14.5
8477355,WILL BUTCHER,D,3,17,20,66,17.26
8476850,RYAN MURRAY,D,3,17,20,67,19.11
8475231,CASEY CIZIKAS,C,12,8,20,81,13.84
8475163,ALEX CHIASSON,RW,10,10,20,81,13.2
8470621,COREY PERRY,RW,7,12,19,82,13.46
8477450,JASON DICKINSON,C,7,12,19,80,14.38
8475834,MARCUS SORENSEN,LW,9,10,19,71,13.37
8476905,CHANDLER STEPHENSON,C,8,11,19,63,13.77
8470047,VALTTERI FILPPULA,C,7,12,19,60,15.72
8478396,NOAH HANIFIN,D,4,15,19,96,20.02
8476326,JOSH ARCHIBALD,RW,10,9,19,67,12.94
8476442,MATT NIETO,LW,7,12,19,72,13.18
8477986,BRANDON MONTOUR,D,5,14,19,92,18.84
8473449,KYLE OKPOSO,RW,8,11,19,89,12.66
8476463,JONAS BRODIN,D,3,16,19,80,20.3
8477406,MATTIAS JANMARK,C,6,13,19,78,14.25
8476981,JOSH ANDERSON,RW,9,10,19,133,15.55
8475181,NICK LEDDY,D,3,16,19,70,20.04
8475738,JORDAN WEAL,C,9,10,19,88,13.24
8474034,PATRICK MAROON,LW,7,12,19,73,12.37
8479944,ZACH ASTON-REESE,C,9,10,19,96,13.91
8476374,SEAN KURALY,C,6,12,18,85,12.96
8469455,JASON SPEZZA,C,6,12,18,71,10.99
8476925,COLTON SISSONS,C,9,9,18,64,14.07
8477488,BRETT PESCE,D,4,14,18,88,20.55
8478407,VINCE DUNN,D,6,12,18,98,15.76
8475766,AUSTIN WATSON,LW,8,10,18,66,11.75
8474040,SAM GAGNER,C,8,10,18,101,13.14
8474056,P.K. SUBBAN,D,5,13,18,119,20.97
8477346,MACKENZIE WEEGAR,D,6,12,18,87,18.79
8476902,ESA LINDELL,D,4,14,18,83,22.19
8473618,MATHIEU PERREAULT,C,8,10,18,77,12.71
8470619,BRIAN BOYLE,C,9,9,18,80,12.24
8470257,ALEXANDER STEEN,LW,7,11,18,75,13.77
8477451,RYAN HARTMAN,RW,8,10,18,91,12.12
8476869,BRADY SKJEI,D,5,13,18,101,19.68
8474581,JAKE GARDINER,D,2,16,18,66,16.45
8476934,BROCK MCGINN,LW,7,10,17,79,12.99
8474091,BRANDON SUTTER,C,8,9,17,90,14.63
8474151,RYAN MCDONAGH,D,2,15,17,67,19.96
8476473,CONNOR MURPHY,D,5,12,17,101,19.95
8478020,MICHAEL AMADIO,C,7,10,17,78,12.42
8474602,JUSTIN SCHULTZ,D,3,14,17,92,18.95
8475752,TYLER PITLICK,C,8,9,17,74,12.03
8478075,ANDERS BJORK,LW,7,10,17,67,12.5
8476875,MIKE MATHESON,D,6,11,17,89,17.66
8477969,MARCUS PETTERSSON,D,2,15,17,66,18.19
8477290,MICHAEL RAFFL,LW,7,10,17,65,12.01
8478843,DENIS MALGIN,C,7,10,17,70,11.88
8477935,SAM BENNETT,C,9,8,17,88,12.34
8476913,DEVIN SHORE,C,7,10,17,64,11.74
8471242,MIKE GREEN,D,3,14,17,88,19.87
8474849,ANTOINE ROUSSEL,LW,7,10,17,72,11.84
8474574,TYLER MYERS,D,4,13,17,102,20.24
8473564,MICHAEL FROLIK,RW,7,10,17,80,12.31
8475279,BEN CHIAROT,D,6,11,17,96,21.37
8476525,COLIN MILLER,D,2,14,16,86,16.67
8474673,TJ BRODIE,D,3,13,16,61,19.51
8477474,MADISON BOWEY,D,3,13,16,69,16.85
8475753,JUSTIN FAULK,D,5,11,16,113,19.71
8476422,MIKE REILLY,D,2,14,16,97,17.28
8476891,MATT GRZELCYK,D,3,13,16,81,17.37
8480144,DAVID KAMPF,C,6,10,16,73,13.33
8473473,MILAN LUCIC,LW,6,10,16,66,12.99
8471260,BLAKE COMEAU,LW,7,9,16,74,14.43
8476392,ADAM LOWRY,C,7,9,16,79,14.43
8477846,RYAN CARPENTER,C,5,11,16,74,13.52
8475160,KYLE CLIFFORD,LW,7,9,16,87,11.01
8478542,EVAN RODRIGUES,LW,7,9,16,93,11.61
8476975,CEDRIC PAQUETTE,C,8,8,16,72,12.63
8475728,JOHAN LARSSON,C,6,10,16,62,14.35
8476878,ZEMGUS GIRGENSONS,C,8,8,16,71,13.4
8474166,ALEC MARTINEZ,D,3,12,15,77,20.44
8477930,PIERRE-EDOUARD BELLEMARE,LW,6,9,15,73,12.94
8476874,OLLI MAATTA,D,3,12,15,69,17.6
8475208,BRIAN DUMOULIN,D,2,13,15,71,19.95
8477931,TOMAS NOSEK,LW,7,8,15,79,11.53
8475772,RILEY SHEAHAN,C,7,8,15,67,12.58
8477240,CARTER ROWNEY,RW,6,9,15,55,12.51
8470626,LOUI ERIKSSON,LW,6,9,15,68,12.3
8476437,VICTOR RASK,C,6,9,15,56,10.6
8476921,JORDAN MARTINOOK,LW,5,10,15,67,11.46
8473546,MICHAEL GRABNER,RW,9,6,15,76,12.33
8474013,IAN COLE,D,2,13,15,69,17.1
8476779,BRAD HUNT,D,5,10,15,90,14.6
8473463,LEO KOMAROV,C,4,11,15,57,12.47
8474571,MIKKEL BOEDKER,LW,5,10,15,70,10.17
8477353,TYLER MOTTE,C,7,7,14,73,12.77
8474250,ZACK SMITH,LW,5,9,14,58,12.06
8477478,WILLIAM CARRIER,LW,7,7,14,80,9.84
8478408,TRAVIS DERMOTT,D,4,10,14,71,16.58
8471794,DARREN HELM,LW,7,7,14,84,13.44
8474098,COLTON SCEVIOUR,C,5,9,14,94,12.83
8479482,MICHAL KEMPNY,D,2,12,14,73,17.86
8477903,GARNET HATHAWAY,RW,7,7,14,66,10.7
8471873,ANTON STRALMAN,D,2,12,14,69,19.9
8475343,NIC DOWD,C,6,8,14,54,10.78
8476441,JOEL EDMUNDSON,D,4,10,14,78,17.7
8475832,TOM KUHNHACKL,RW,6,8,14,57,11.31
8473446,ERIK JOHNSON,D,3,11,14,92,19.92
8476474,STEFAN NOESEN,RW,8,6,14,88,11.5
8478906,MARKUS NUTIVAARA,D,4,10,14,68,15.5
8470655,DAVID BACKES,RW,4,10,14,80,9.82
8476917,ADAM PELECH,D,2,12,14,76,19.77
8470144,FRANS NIELSEN,C,5,9,14,79,13.61
8476873,MARK JANKOWSKI,C,7,7,14,52,11.15
8476915,JUJHAR KHAIRA,LW,6,8,14,65,12.28
8476312,JOSH MANSON,D,2,11,13,71,19.74
8474697,MARK BOROWIECKI,D,4,9,13,65,16.91
8478432,CHRISTIAN FISCHER,RW,7,6,13,83,11.13
8476894,BRENDAN LEIPSIC,LW,4,9,13,55,9.71
8479442,TROY STECHER,D,3,10,13,67,15.27
8477018,BEN HUTTON,D,3,10,13,88,17.85
8476858,PHILLIP DI GIUSEPPE,LW,4,9,13,89,11.04
8471709,MARC-EDOUARD VLASIC,D,3,10,13,64,19.34
8473504,CAL CLUTTERBUCK,RW,5,8,13,62,13.14
8476886,SLATER KOEKKOEK,D,3,10,13,64,15.99
8475177,CALVIN DE HAAN,D,2,11,13,78,18.78
8476331,DYLAN DEMELO,D,1,12,13,72,19.04
8476429,SCOTT MAYFIELD,D,4,9,13,78,18.83
8477462,ROBERT HAGG,D,3,10,13,51,15.16
8477851,JORDAN OESTERLE,D,3,10,13,63,16.5
8476941,CONNOR CARRICK,D,3,10,13,54,14.21
8474584,MICHAEL DEL ZOTTO,D,1,12,13,64,17.68
8478443,BRANDON CARLO,D,3,10,13,89,19.39
8475780,CHRIS WAGNER,RW,7,6,13,76,12.23
8476879,CODY CECI,D,3,10,13,64,19.69
8470755,BRAD RICHARDSON,C,7,6,13,79,13.51
8475690,CHRISTOPHER TANEV,D,1,12,13,45,18.64
8471699,ANDREW COGLIANO,LW,4,9,13,65,12.2
8477464,NIC PETAN,LW,3,9,12,67,10.66
8476822,LUKE GLENDENING,RW,6,6,12,73,14.86
8474062,RILEY NASH,C,4,8,12,60,11.56
8475455,BRENDEN DILLON,D,1,11,12,52,18.42
8475235,NICOLAS DESLAURIERS,LW,6,6,12,61,9.83
8477938,HAYDN FLEURY,D,3,9,12,70,13.19
8476470,NATHAN BEAULIEU,D,2,10,12,61,16.15
8476439,BRETT RITCHIE,RW,5,7,12,69,10.28
8476931,JAKE MCCABE,D,3,9,12,63,17.72
8473453,TREVOR LEWIS,C,5,7,12,89,11.93
8477507,NIKITA ZADOROV,D,4,8,12,64,16.82
8477922,MELKER KARLSSON,C,6,6,12,58,11.97
8476449,SCOTT HARRINGTON,D,2,10,12,51,13.46
8479376,VICTOR METE,D,3,9,12,60,15.57
8471743,VLADIMIR SOBOTKA,LW,4,8,12,75,13.83
8479458,NIKITA ZAITSEV,D,2,10,12,61,20.77
8477943,BRENDAN PERLINI,LW,6,6,12,76,10.72
8477454,ADAM ERNE,LW,5,7,12,67,11.51
8471817,RYAN REAVES,RW,5,7,12,55,10.17
8476356,TOBIAS RIEDER,C,4,8,12,75,11.14
8475462,RADKO GUDAS,D,1,11,12,78,16.16
8470775,NATE THOMPSON,C,4,8,12,56,12.55
8474027,JUSTIN BRAUN,D,1,11,12,63,16.82
8475796,MARK PYSYK,D,4,8,12,54,13.03
8475735,GREG MCKEGG,C,6,6,12,46,9.72
8477455,JACOB DE LA ROSE,LW,4,8,12,57,10.72
8474612,TRAVIS HAMONIC,D,3,9,12,90,20.04
8474567,ZACH BOGOSIAN,D,1,10,11,66,16.61
8474218,JASON DEMERS,D,1,10,11,61,19.39
8476988,MATT BENNING,D,2,9,11,55,13.08
8480172,JAN RUTTA,D,2,9,11,66,15.03
8476967,BRETT KULAK,D,2,9,11,93,16.5
8475750,JON MERRILL,D,3,8,11,54,17.31
8475747,PATRIK NEMETH,D,2,9,11,71,20.28
8474207,NICK HOLDEN,D,3,8,11,81,17.65
8475841,TIM HEED,D,2,9,11,60,12.84
8472382,ANDY GREENE,D,1,10,11,58,18.72
8476440,MARKUS GRANLUND,C,6,5,11,57,11.17
8475807,JOAKIM NORDSTROM,LW,5,6,11,65,11.92
8477527,ROSS JOHNSTON,LW,5,6,11,39,8.18
8474291,JAY BEAGLE,C,3,8,11,53,12.42
8477046,JOAKIM RYAN,D,2,9,11,76,17.58
8465009,ZDENO CHARA,D,3,8,11,70,19.82
8476948,CHARLES HUDON,LW,5,6,11,83,11.4
8468493,RON HAINSEY,D,1,10,11,47,19.57
8474736,ZAC RINALDO,C,6,5,11,51,8.33
8470607,BRENT SEABROOK,D,3,7,10,78,17.43
8477509,MIRCO MUELLER,D,2,8,10,41,16.92
8474668,DALE WEISE,RW,3,7,10,47,9.59
8477213,TIM SCHALLER,C,5,5,10,57,11.32
8474125,CARL GUNNARSSON,D,3,7,10,50,15.2
8475233,DAVID SAVARD,D,1,9,10,78,19.52
8476467,JAMIE OLEKSIAK,D,3,7,10,61,15.24
8474618,MARCO SCANDELLA,D,3,7,10,67,16.88
8475188,BRAYDEN MCNABB,D,2,8,10,60,18.95
8474709,MATT MARTIN,LW,5,5,10,53,10.48
8471426,TROY BROUWER,RW,6,4,10,53,9.9
8476457,ADAM LARSSON,D,2,8,10,71,19.03
8477845,TREVOR VAN RIEMSDYK,D,2,8,10,66,14.4
8475790,ERIK GUDBRANSON,D,3,7,10,78,18.31
8474818,JORDIE BENN,D,1,8,9,66,15.85
8480147,OSCAR FANTENBERG,D,2,7,9,66,15.33
8477401,JOHN HAYDEN,RW,5,4,9,55,9.69
8471686,MARC STAAL,D,1,8,9,53,17.06
8470187,JOHNNY BOYCHUK,D,1,8,9,84,16.71
8475179,DMITRY KULIKOV,D,1,8,9,57,18.58
8470151,JAY BOUWMEESTER,D,1,8,9,56,20.33
8470110,TREVOR DALEY,D,1,7,8,50,15.38
8471729,KRIS RUSSELL,D,0,8,8,48,16.47
8471769,NIKLAS HJALMARSSON,D,1,7,8,42,17.98
8471677,JACK JOHNSON,D,1,7,8,56,18.5
8470601,BRAYDON COBURN,D,1,7,8,62,13.85
8468674,DERYK ENGELLAND,D,1,7,8,66,17.04
8471716,JUSTIN ABDELKADER,LW,2,6,8,55,11.77
8477850,CHRISTIAN FOLIN,D,2,6,8,50,14.11
8475186,JOHN MOORE,D,3,5,8,74,16.11
8471284,ANDREJ SEKERA,D,1,7,8,62,16.96
8475324,NICK JENSEN,D,0,8,8,55,17.18
8473415,ALEX BIEGA,D,0,8,8,75,15.9
8475762,DEREK FORBORT,D,1,6,7,58,17.32
8474688,GREG PATERYN,D,0,7,7,61,15.09
8476207,BRIAN GIBBONS,LW,3,4,7,42,9.9
8477244,CHAD RUHWEDEL,D,2,5,7,59,14.44
8474145,ROBERT BORTUZZO,D,1,6,7,52,13.01
8475868,ANTHONY BITETTO,D,0,7,7,57,14.32
8469465,DAN HAMHUIS,D,0,7,7,41,14.22
8475268,GABRIEL BOURQUE,LW,2,5,7,41,8.86
8471392,ROMAN POLAK,D,0,6,6,50,16.25
8473560,KORBINIAN HOLZER,D,1,5,6,46,15.43
8474090,BRENDAN SMITH,D,1,5,6,44,11.41
8475625,MATT IRWIN,D,0,6,6,77,13.71
8474134,YANNICK WEBER,D,1,4,5,60,13.4
8474568,LUKE SCHENN,D,1,4,5,62,12.35
8470318,JONATHAN ERICSSON,D,0,2,2,48,14.12
